Plurales irregulares en inglés

eneralmente a los sustantivos (nouns) se les agrega “s” para transformarlos en plural, por ejemplo:

Book – Books
Paper – Papers
Apple – Apples
Key - Keys

Sin embargo, en algunas ocasiones existen reglas diferentes.

Plural de sustantivos terminados en la letra y
Cuando los sustantivos culminan con la letra “y” y esta es precedida por una consonante, la letra “y” es sustituida por “ies”. Por ejemplo:

Story – Stories.
Strawberry – Strawberries.
Candy – Candies
Plural de sustantivos terminados en las letras ch, x, s, sh, o
Cuando los sustantivos culminan con las letras “ch”, “x”, “s”, “sh”, “o”, se agrega “es”; por ejemplo:

Beach – Beaches
Class – Classes
Box – Boxes
Brush – Brushes
Tomato – Tomatoes
Plural de sustantivos terminados en las letras f, fe, lf
Cuando las palabras culminan con las letras “f”, “fe”, “lf”, estas se sustituyen por “ves”; por ejemplo:

Knife – Knives
Life - Lives
Wolf – Wolves
Plural de sustantivos irregulares
Existen sustantivos en los cuales su plural es totalmente diferente a las formas anteriores (Irregular plural nouns), por ejemplo:

Man – Men
Mouse – Mice
Louse – Lice
Bison – Bison
Woman – Women
Policeman - Policemen
Child – Children
Person – People
Fish – Fish
Tooth – Teeth
Goose – Geese
Sheep – Sheep
Moose – Moose
Foot – Feet
Ox – Oxen
Deer – Deer
Offspring – Offspring